E11111100111111
001000111100000
001000100100000
000011100111110
000010100100010
000010110111110
001110000000010
111000001110011
101111101010000
100100101010000
100000111011110
111010000010000
100011111110111
100010101000101
00001110111110S